11111111111111111111
1P000000000000000001
11111111111111111101
10010001000100010001
1E000100010001000101
11111111111111111101
10000000000000000001
10111111111111111111
100000000000000000C1
11111111111111111111